0 0 39
00 00 00 00 00 00 00 00 00 00 00 00 00 00 00 00 00
00 00 00 00 00 00 00 00 00 00 00 00 00 00 00 00 00
00 00 00 00 00 00 00 00 00 00 00 00 00 00 00 00 00
00 00 00 01 01 01 01 01 01 01 01 01 00 00 00 00 00 
00 00 00 01 03 08 01 01 00 00 12 01 01 01 00 00 00 
00 00 00 01 05 01 01 01 00 01 09 00 12 01 00 00 00 
00 00 01 01 00 01 00 00 00 01 01 01 00 01 00 00 00 
00 00 01 04 00 00 18 01 01 01 17 01 00 01 00 00 00 
00 00 01 22 01 01 00 01 02 01 16 01 18 01 00 00 00 
00 00 01 22 01 01 00 01 00 01 05 01 00 01 00 00 00 
00 00 01 00 16 00 00 01 04 00 00 14 00 01 00 00 00 
00 00 01 01 01 01 01 01 01 01 01 01 01 01 00 00 00
00 00 00 00 00 00 00 00 00 00 00 00 00 00 00 00 00
00 00 00 00 00 00 00 00 00 00 00 00 00 00 00 00 00
00 00 00 00 00 00 00 00 00 00 00 00 00 00 00 00 00
00 00 00 00 00 00 00 00 00 00 00 00 00 00 00 00 00
00 00 00 00 00 00 00 00 00 00 00 00 00 00 00 00 00